NO ./maps/n.xpm
SO ./maps/s.xpm
WE ./maps/w.xpm
EA ./maps/e.xpm
F 67,70,91
C 124,177,255

111111111111111111111
100111W00000000000001
100010011111111111111
10001001
10000001
11111111
