NO ./maps/greystone.xpm
SO ./maps/greystone.xpm
WE ./maps/greystone.xpm
EA ./maps/greystone.xpm

F 220,100,205
C 225,30,0

    1111111111111111111111111111111111111
 1  10000000001100000000000000000000000111
101100000111000000000000011111111111011101
100100000000000000000000111111111  111  1
111111111011000001110000000000001
1000000000110000011101111111111111
11110111111111011100000010001
11110111111111011101010010001
11000000110101011100000010001
10000000000000001100000010001
10000000000000001101010010001
1100000111010101111101111N00111
11110111 1110101    101111010001
11111111 1111111    11111111111 1
11111111111
11111111111
11111111111
